1,1,1,1,1,1,1
1,2,0,0,0,3,0
1,0,1,1,1,0,1
1,0,1,1,1,0,1
1,0,1,1,1,5,0
1,5,0,0,3,10,1
1,0,1,1,0,1,1
