1,1,0,1,0,1,1
1,1,0,1,0,1,1
0,3,9,0,9,3,0
1,0,1,1,1,0,1
2,9,4,1,2,9,4
10,1,8,0,10,1,8
1,1,1,1,1,1,1
