1,1,1,1,1,1,1
1,2,0,0,4,1,2
1,0,1,1,5,0,10
1,0,1,1,0,1,1
1,8,3,0,10,1,1
1,1,0,1,1,1,1
1,2,10,1,1,1,1
