1,8,4,1,1,1,1
1,1,0,1,1,1,1
1,2,9,0,4,1,1
1,0,1,1,0,1,1
1,0,1,1,5,0,4
1,8,0,0,10,1,8
1,1,1,1,1,1,1
