2,0,9,3,9,0,4
0,1,1,0,1,1,0
7,1,1,0,1,1,5
0,1,1,0,1,1,0
7,1,1,0,1,1,5
0,1,1,0,1,1,0
8,0,3,9,3,0,10
