1,1,1,1,1,1,1
0,3,0,3,0,4,1
1,0,1,0,1,0,1
1,0,1,8,0,7,1
0,7,1,1,1,0,1
1,8,3,0,0,7,1
1,1,0,1,1,0,1
