1,1,1,1,1,1,1
4,1,2,0,0,4,1
8,0,7,1,1,0,1
1,1,0,1,1,0,1
1,1,8,0,3,10,1
1,1,1,1,0,1,1
1,1,1,1,8,4,1
