1,1,1,1,2,10,1
1,1,1,1,0,1,1
1,1,2,0,9,4,1
1,1,0,1,1,0,1
2,0,7,1,1,0,1
10,1,8,0,0,10,1
1,1,1,1,1,1,1
