1,1,1,1,1,1,1
4,1,2,0,4,1,2
8,3,10,1,8,3,10
1,0,1,1,1,0,1
0,9,3,0,3,9,0
1,1,0,1,0,1,1
1,1,0,1,0,1,1
