1,1,0,1,2,10,1
1,1,5,0,7,1,1
0,0,7,1,8,4,1
1,1,0,1,1,0,1
0,0,7,1,2,10,1
1,1,5,0,7,1,1
1,1,0,1,8,4,1
