1,1,0,1,1,0,1
1,2,9,0,0,7,1
0,7,1,1,1,0,1
1,0,1,2,0,7,1
1,0,1,0,1,0,1
0,9,0,9,0,10,1
1,1,1,1,1,1,1
