1,1,1,1,1,1,1
1,2,0,0,0,3,0
1,0,1,1,1,0,1
1,0,1,2,0,9,0
1,0,1,0,1,1,1
1,5,0,7,1,1,1
1,0,1,0,1,1,1
