1,1,0,1,0,1,1
1,1,0,1,0,1,1
0,3,9,0,9,3,0
1,0,1,1,1,0,1
1,0,1,1,1,0,1
0,9,0,0,0,9,0
1,1,1,1,1,1,1
