1,1,1,0,1,0,1
1,1,1,5,0,7,1
1,1,1,0,1,0,1
0,3,0,10,1,0,1
1,0,1,1,1,0,1
0,9,0,0,0,10,1
1,1,1,1,1,1,1
